event_date,year,month_number,season,num_incidents,num_injured,num_killed,num_injured_or_killed,days_since_prev_incident
1-Jan-14,2014,1,Winter,1,2,2,4,
3-Jan-14,2014,1,Winter,1,3,1,4,2
5-Jan-14,2014,1,Winter,1,3,1,4,2
11-Jan-14,2014,1,Winter,1,4,0,4,6
12-Jan-14,2014,1,Winter,3,16,0,16,1
13-Jan-14,2014,1,Winter,1,4,0,4,1
14-Jan-14,2014,1,Winter,1,4,0,4,1
16-Jan-14,2014,1,Winter,2,5,7,12,2
20-Jan-14,2014,1,Winter,1,4,0,4,4
21-Jan-14,2014,1,Winter,1,3,2,5,1
25-Jan-14,2014,1,Winter,2,8,1,9,4
27-Jan-14,2014,1,Winter,2,8,1,9,2
3-Feb-14,2014,2,Winter,1,2,3,5,7
5-Feb-14,2014,2,Winter,1,3,1,4,2
6-Feb-14,2014,2,Winter,1,4,0,4,1
7-Feb-14,2014,2,Winter,1,5,0,5,1
12-Feb-14,2014,2,Winter,3,11,2,13,5
15-Feb-14,2014,2,Winter,1,5,0,5,3
16-Feb-14,2014,2,Winter,5,26,4,30,1
20-Feb-14,2014,2,Winter,2,2,8,10,4
22-Feb-14,2014,2,Winter,1,4,0,4,2
25-Feb-14,2014,2,Winter,1,1,5,6,3
1-Mar-14,2014,3,Spring,2,8,1,9,4
5-Mar-14,2014,3,Spring,1,2,3,5,4
8-Mar-14,2014,3,Spring,2,9,1,10,3
9-Mar-14,2014,3,Spring,2,7,3,10,1
14-Mar-14,2014,3,Spring,1,4,0,4,5
16-Mar-14,2014,3,Spring,2,5,3,8,2
21-Mar-14,2014,3,Spring,1,4,0,4,5
23-Mar-14,2014,3,Spring,3,13,2,15,2
30-Mar-14,2014,3,Spring,2,10,0,10,7
2-Apr-14,2014,4,Spring,1,16,4,20,3
5-Apr-14,2014,4,Spring,3,12,2,14,3
6-Apr-14,2014,4,Spring,2,8,0,8,1
7-Apr-14,2014,4,Spring,1,4,0,4,1
9-Apr-14,2014,4,Spring,2,5,3,8,2
11-Apr-14,2014,4,Spring,1,4,0,4,2
12-Apr-14,2014,4,Spring,1,3,1,4,1
14-Apr-14,2014,4,Spring,1,4,0,4,2
20-Apr-14,2014,4,Spring,3,13,2,15,6
22-Apr-14,2014,4,Spring,1,3,1,4,2
25-Apr-14,2014,4,Spring,1,3,2,5,3
27-Apr-14,2014,4,Spring,1,5,0,5,2
29-Apr-14,2014,4,Spring,1,6,1,7,2
30-Apr-14,2014,4,Spring,1,4,0,4,1
3-May-14,2014,5,Spring,1,4,4,8,3
4-May-14,2014,5,Spring,2,7,1,8,1
10-May-14,2014,5,Spring,3,12,4,16,6
11-May-14,2014,5,Spring,1,7,0,7,1
12-May-14,2014,5,Spring,1,4,0,4,1
13-May-14,2014,5,Spring,1,5,0,5,1
17-May-14,2014,5,Spring,2,8,1,9,4
18-May-14,2014,5,Spring,1,7,0,7,1
21-May-14,2014,5,Spring,1,3,1,4,3
23-May-14,2014,5,Spring,3,17,7,24,2
24-May-14,2014,5,Spring,2,5,3,8,1
25-May-14,2014,5,Spring,1,3,1,4,1
31-May-14,2014,5,Spring,1,3,1,4,6
1-Jun-14,2014,6,Summer,2,9,1,10,1
2-Jun-14,2014,6,Summer,1,7,0,7,1
3-Jun-14,2014,6,Summer,1,4,1,5,1
4-Jun-14,2014,6,Summer,1,3,1,4,1
7-Jun-14,2014,6,Summer,2,8,2,10,3
8-Jun-14,2014,6,Summer,1,4,1,5,1
9-Jun-14,2014,6,Summer,1,6,0,6,1
13-Jun-14,2014,6,Summer,1,1,3,4,4
15-Jun-14,2014,6,Summer,2,8,0,8,2
20-Jun-14,2014,6,Summer,1,4,0,4,5
21-Jun-14,2014,6,Summer,2,9,0,9,1
22-Jun-14,2014,6,Summer,1,3,1,4,1
24-Jun-14,2014,6,Summer,1,7,2,9,2
25-Jun-14,2014,6,Summer,1,5,0,5,1
26-Jun-14,2014,6,Summer,2,7,2,9,1
27-Jun-14,2014,6,Summer,1,3,1,4,1
28-Jun-14,2014,6,Summer,2,11,0,11,1
29-Jun-14,2014,6,Summer,3,18,2,20,1
30-Jun-14,2014,6,Summer,1,3,1,4,1
2-Jul-14,2014,7,Summer,1,5,0,5,2
4-Jul-14,2014,7,Summer,1,5,0,5,2
5-Jul-14,2014,7,Summer,5,29,1,30,1
6-Jul-14,2014,7,Summer,3,10,2,12,1
7-Jul-14,2014,7,Summer,2,8,1,9,1
8-Jul-14,2014,7,Summer,1,5,0,5,1
9-Jul-14,2014,7,Summer,1,1,6,7,1
11-Jul-14,2014,7,Summer,1,3,1,4,2
12-Jul-14,2014,7,Summer,1,2,3,5,1
13-Jul-14,2014,7,Summer,3,14,0,14,1
14-Jul-14,2014,7,Summer,1,4,1,5,1
19-Jul-14,2014,7,Summer,1,4,0,4,5
20-Jul-14,2014,7,Summer,2,6,2,8,1
21-Jul-14,2014,7,Summer,2,10,0,10,1
23-Jul-14,2014,7,Summer,1,4,0,4,2
25-Jul-14,2014,7,Summer,1,6,1,7,2
26-Jul-14,2014,7,Summer,3,11,6,17,1
27-Jul-14,2014,7,Summer,1,5,0,5,1
28-Jul-14,2014,7,Summer,1,4,1,5,1
30-Jul-14,2014,7,Summer,1,3,2,5,2
1-Aug-14,2014,8,Summer,1,3,1,4,2
2-Aug-14,2014,8,Summer,3,13,4,17,1
3-Aug-14,2014,8,Summer,4,17,5,22,1
4-Aug-14,2014,8,Summer,1,5,0,5,1
6-Aug-14,2014,8,Summer,1,1,3,4,2
8-Aug-14,2014,8,Summer,3,11,1,12,2
9-Aug-14,2014,8,Summer,1,8,1,9,1
10-Aug-14,2014,8,Summer,4,24,2,26,1
12-Aug-14,2014,8,Summer,2,6,3,9,2
13-Aug-14,2014,8,Summer,2,8,0,8,1
14-Aug-14,2014,8,Summer,1,3,1,4,1
16-Aug-14,2014,8,Summer,2,9,1,10,2
17-Aug-14,2014,8,Summer,4,15,1,16,1
18-Aug-14,2014,8,Summer,1,4,0,4,1
20-Aug-14,2014,8,Summer,1,5,0,5,2
24-Aug-14,2014,8,Summer,3,10,5,15,4
27-Aug-14,2014,8,Summer,1,3,1,4,3
29-Aug-14,2014,8,Summer,1,1,3,4,2
31-Aug-14,2014,8,Summer,1,5,0,5,2
2-Sep-14,2014,9,Fall,2,8,2,10,2
3-Sep-14,2014,9,Fall,1,6,0,6,1
4-Sep-14,2014,9,Fall,1,5,0,5,1
6-Sep-14,2014,9,Fall,2,9,0,9,2
11-Sep-14,2014,9,Fall,1,7,1,8,5
14-Sep-14,2014,9,Fall,2,7,3,10,3
15-Sep-14,2014,9,Fall,1,5,0,5,1
18-Sep-14,2014,9,Fall,1,0,8,8,3
19-Sep-14,2014,9,Fall,1,4,0,4,1
20-Sep-14,2014,9,Fall,1,2,2,4,1
21-Sep-14,2014,9,Fall,1,4,0,4,1
26-Sep-14,2014,9,Fall,1,4,1,5,5
27-Sep-14,2014,9,Fall,1,5,0,5,1
28-Sep-14,2014,9,Fall,2,19,0,19,1
29-Sep-14,2014,9,Fall,2,11,1,12,1
4-Oct-14,2014,10,Fall,2,6,2,8,5
5-Oct-14,2014,10,Fall,2,6,4,10,1
8-Oct-14,2014,10,Fall,2,4,4,8,3
11-Oct-14,2014,10,Fall,1,5,0,5,3
12-Oct-14,2014,10,Fall,2,4,4,8,1
13-Oct-14,2014,10,Fall,1,4,0,4,1
14-Oct-14,2014,10,Fall,1,2,3,5,1
16-Oct-14,2014,10,Fall,1,3,1,4,2
18-Oct-14,2014,10,Fall,3,11,1,12,2
24-Oct-14,2014,10,Fall,1,1,5,6,6
26-Oct-14,2014,10,Fall,1,0,4,4,2
29-Oct-14,2014,10,Fall,1,5,0,5,3
5-Nov-14,2014,11,Fall,1,4,0,4,7
7-Nov-14,2014,11,Fall,2,8,0,8,2
8-Nov-14,2014,11,Fall,1,5,0,5,1
15-Nov-14,2014,11,Fall,2,3,5,8,7
16-Nov-14,2014,11,Fall,2,10,1,11,1
18-Nov-14,2014,11,Fall,1,4,0,4,2
19-Nov-14,2014,11,Fall,1,3,1,4,1
21-Nov-14,2014,11,Fall,1,6,0,6,2
22-Nov-14,2014,11,Fall,3,5,9,14,1
23-Nov-14,2014,11,Fall,2,8,1,9,1
26-Nov-14,2014,11,Fall,1,6,0,6,3
27-Nov-14,2014,11,Fall,1,3,2,5,1
28-Nov-14,2014,11,Fall,1,4,0,4,1
29-Nov-14,2014,11,Fall,2,5,4,9,1
30-Nov-14,2014,11,Fall,2,9,0,9,1
2-Dec-14,2014,12,Winter,2,10,1,11,2
7-Dec-14,2014,12,Winter,1,4,0,4,5
12-Dec-14,2014,12,Winter,1,4,0,4,5
13-Dec-14,2014,12,Winter,1,5,0,5,1
14-Dec-14,2014,12,Winter,1,4,1,5,1
15-Dec-14,2014,12,Winter,1,0,7,7,1
16-Dec-14,2014,12,Winter,1,4,0,4,1
20-Dec-14,2014,12,Winter,1,0,4,4,4
21-Dec-14,2014,12,Winter,3,14,4,18,1
22-Dec-14,2014,12,Winter,3,10,5,15,1
23-Dec-14,2014,12,Winter,1,3,1,4,1
24-Dec-14,2014,12,Winter,1,3,1,4,1
26-Dec-14,2014,12,Winter,1,3,1,4,2
27-Dec-14,2014,12,Winter,2,7,1,8,1
29-Dec-14,2014,12,Winter,1,4,0,4,2
1-Jan-15,2015,1,Winter,1,5,0,5,3
2-Jan-15,2015,1,Winter,1,4,1,5,1
4-Jan-15,2015,1,Winter,2,5,5,10,2
6-Jan-15,2015,1,Winter,1,3,1,4,2
7-Jan-15,2015,1,Winter,1,3,1,4,1
8-Jan-15,2015,1,Winter,1,3,1,4,1
9-Jan-15,2015,1,Winter,1,0,4,4,1
10-Jan-15,2015,1,Winter,1,2,2,4,1
11-Jan-15,2015,1,Winter,3,13,3,16,1
13-Jan-15,2015,1,Winter,2,7,2,9,2
19-Jan-15,2015,1,Winter,1,5,2,7,6
20-Jan-15,2015,1,Winter,1,3,1,4,1
23-Jan-15,2015,1,Winter,1,6,0,6,3
24-Jan-15,2015,1,Winter,2,6,7,13,1
26-Jan-15,2015,1,Winter,1,3,1,4,2
28-Jan-15,2015,1,Winter,1,3,1,4,2
31-Jan-15,2015,1,Winter,1,0,4,4,3
1-Feb-15,2015,2,Winter,2,10,1,11,1
5-Feb-15,2015,2,Winter,1,3,3,6,4
6-Feb-15,2015,2,Winter,1,4,1,5,1
7-Feb-15,2015,2,Winter,1,2,5,7,1
8-Feb-15,2015,2,Winter,1,6,0,6,1
9-Feb-15,2015,2,Winter,1,1,3,4,1
15-Feb-15,2015,2,Winter,1,5,0,5,6
17-Feb-15,2015,2,Winter,1,3,1,4,2
20-Feb-15,2015,2,Winter,1,4,0,4,3
22-Feb-15,2015,2,Winter,3,7,7,14,2
23-Feb-15,2015,2,Winter,1,4,0,4,1
25-Feb-15,2015,2,Winter,1,1,3,4,2
26-Feb-15,2015,2,Winter,1,1,8,9,1
28-Feb-15,2015,2,Winter,1,3,1,4,2
1-Mar-15,2015,3,Spring,2,9,1,10,1
4-Mar-15,2015,3,Spring,1,4,3,7,3
7-Mar-15,2015,3,Spring,1,4,0,4,3
8-Mar-15,2015,3,Spring,1,3,1,4,1
9-Mar-15,2015,3,Spring,1,3,1,4,1
10-Mar-15,2015,3,Spring,1,5,0,5,1
13-Mar-15,2015,3,Spring,1,3,2,5,3
14-Mar-15,2015,3,Spring,2,9,0,9,1
15-Mar-15,2015,3,Spring,1,4,0,4,1
17-Mar-15,2015,3,Spring,1,4,3,7,2
18-Mar-15,2015,3,Spring,2,8,2,10,1
20-Mar-15,2015,3,Spring,2,9,1,10,2
21-Mar-15,2015,3,Spring,1,4,0,4,1
22-Mar-15,2015,3,Spring,1,6,1,7,1
23-Mar-15,2015,3,Spring,1,4,1,5,1
24-Mar-15,2015,3,Spring,1,0,4,4,1
26-Mar-15,2015,3,Spring,1,4,0,4,2
27-Mar-15,2015,3,Spring,1,7,0,7,1
2-Apr-15,2015,4,Spring,1,5,0,5,6
3-Apr-15,2015,4,Spring,1,4,0,4,1
5-Apr-15,2015,4,Spring,4,16,2,18,2
7-Apr-15,2015,4,Spring,1,3,1,4,2
16-Apr-15,2015,4,Spring,1,0,5,5,9
18-Apr-15,2015,4,Spring,5,20,2,22,2
19-Apr-15,2015,4,Spring,1,4,0,4,1
21-Apr-15,2015,4,Spring,1,3,2,5,2
25-Apr-15,2015,4,Spring,2,10,1,11,4
27-Apr-15,2015,4,Spring,2,6,4,10,2
1-May-15,2015,5,Spring,1,3,2,5,4
3-May-15,2015,5,Spring,5,21,5,26,2
4-May-15,2015,5,Spring,1,3,1,4,1
7-May-15,2015,5,Spring,2,8,0,8,3
10-May-15,2015,5,Spring,3,11,2,13,3
12-May-15,2015,5,Spring,2,4,6,10,2
16-May-15,2015,5,Spring,3,14,0,14,4
17-May-15,2015,5,Spring,1,18,9,27,1
18-May-15,2015,5,Spring,2,8,1,9,1
20-May-15,2015,5,Spring,1,3,1,4,2
23-May-15,2015,5,Spring,1,2,2,4,3
24-May-15,2015,5,Spring,4,19,1,20,1
25-May-15,2015,5,Spring,1,4,1,5,1
26-May-15,2015,5,Spring,1,2,2,4,1
28-May-15,2015,5,Spring,3,12,1,13,2
30-May-15,2015,5,Spring,1,4,0,4,2
31-May-15,2015,5,Spring,4,11,7,18,1
3-Jun-15,2015,6,Summer,1,1,3,4,3
5-Jun-15,2015,6,Summer,2,8,1,9,2
6-Jun-15,2015,6,Summer,2,9,1,10,1
7-Jun-15,2015,6,Summer,1,0,5,5,1
9-Jun-15,2015,6,Summer,1,3,1,4,2
10-Jun-15,2015,6,Summer,1,3,1,4,1
11-Jun-15,2015,6,Summer,2,11,2,13,1
12-Jun-15,2015,6,Summer,1,4,0,4,1
13-Jun-15,2015,6,Summer,5,17,6,23,1
14-Jun-15,2015,6,Summer,3,11,1,12,1
15-Jun-15,2015,6,Summer,1,4,0,4,1
16-Jun-15,2015,6,Summer,1,4,0,4,1
17-Jun-15,2015,6,Summer,1,0,9,9,1
19-Jun-15,2015,6,Summer,1,4,0,4,2
20-Jun-15,2015,6,Summer,3,26,1,27,1
21-Jun-15,2015,6,Summer,2,8,1,9,1
22-Jun-15,2015,6,Summer,1,7,0,7,1
24-Jun-15,2015,6,Summer,1,4,0,4,2
27-Jun-15,2015,6,Summer,2,7,1,8,3
28-Jun-15,2015,6,Summer,3,17,0,17,1
29-Jun-15,2015,6,Summer,1,4,0,4,1
2-Jul-15,2015,7,Summer,1,3,1,4,3
4-Jul-15,2015,7,Summer,5,19,2,21,2
5-Jul-15,2015,7,Summer,3,20,1,21,1
7-Jul-15,2015,7,Summer,2,4,4,8,2
12-Jul-15,2015,7,Summer,2,7,2,9,5
13-Jul-15,2015,7,Summer,2,8,1,9,1
14-Jul-15,2015,7,Summer,1,4,0,4,1
15-Jul-15,2015,7,Summer,5,20,5,25,1
16-Jul-15,2015,7,Summer,2,7,6,13,1
17-Jul-15,2015,7,Summer,2,9,0,9,1
18-Jul-15,2015,7,Summer,4,15,3,18,1
19-Jul-15,2015,7,Summer,3,14,0,14,1
20-Jul-15,2015,7,Summer,1,6,0,6,1
21-Jul-15,2015,7,Summer,1,3,1,4,1
22-Jul-15,2015,7,Summer,2,6,5,11,1
23-Jul-15,2015,7,Summer,1,9,3,12,1
24-Jul-15,2015,7,Summer,1,5,2,7,1
25-Jul-15,2015,7,Summer,1,4,0,4,1
26-Jul-15,2015,7,Summer,2,7,2,9,1
27-Jul-15,2015,7,Summer,1,5,0,5,1
30-Jul-15,2015,7,Summer,1,4,0,4,3
1-Aug-15,2015,8,Summer,1,4,0,4,2
2-Aug-15,2015,8,Summer,5,29,1,30,1
3-Aug-15,2015,8,Summer,1,5,0,5,1
4-Aug-15,2015,8,Summer,1,4,1,5,1
6-Aug-15,2015,8,Summer,1,4,0,4,2
7-Aug-15,2015,8,Summer,1,0,4,4,1
8-Aug-15,2015,8,Summer,3,14,11,25,1
9-Aug-15,2015,8,Summer,3,10,2,12,1
10-Aug-15,2015,8,Summer,1,4,0,4,1
15-Aug-15,2015,8,Summer,3,10,2,12,5
16-Aug-15,2015,8,Summer,3,15,0,15,1
19-Aug-15,2015,8,Summer,1,4,3,7,3
20-Aug-15,2015,8,Summer,1,2,2,4,1
21-Aug-15,2015,8,Summer,2,13,2,15,1
22-Aug-15,2015,8,Summer,2,5,3,8,1
23-Aug-15,2015,8,Summer,1,7,1,8,1
25-Aug-15,2015,8,Summer,1,3,1,4,2
26-Aug-15,2015,8,Summer,3,8,4,12,1
27-Aug-15,2015,8,Summer,1,2,2,4,1
28-Aug-15,2015,8,Summer,1,3,1,4,1
29-Aug-15,2015,8,Summer,2,5,4,9,1
30-Aug-15,2015,8,Summer,1,4,1,5,1
5-Sep-15,2015,9,Fall,4,14,2,16,6
7-Sep-15,2015,9,Fall,2,8,2,10,2
8-Sep-15,2015,9,Fall,2,8,0,8,1
10-Sep-15,2015,9,Fall,1,0,5,5,2
11-Sep-15,2015,9,Fall,1,5,0,5,1
12-Sep-15,2015,9,Fall,4,17,3,20,1
13-Sep-15,2015,9,Fall,1,5,1,6,1
15-Sep-15,2015,9,Fall,1,4,0,4,2
17-Sep-15,2015,9,Fall,2,4,6,10,2
19-Sep-15,2015,9,Fall,1,3,1,4,2
20-Sep-15,2015,9,Fall,3,14,2,16,1
23-Sep-15,2015,9,Fall,3,12,1,13,3
24-Sep-15,2015,9,Fall,1,5,0,5,1
25-Sep-15,2015,9,Fall,1,4,0,4,1
27-Sep-15,2015,9,Fall,3,18,0,18,2
28-Sep-15,2015,9,Fall,4,14,5,19,1
1-Oct-15,2015,10,Fall,1,9,10,19,3
2-Oct-15,2015,10,Fall,1,4,1,5,1
6-Oct-15,2015,10,Fall,1,5,0,5,4
9-Oct-15,2015,10,Fall,1,3,1,4,3
10-Oct-15,2015,10,Fall,3,13,1,14,1
12-Oct-15,2015,10,Fall,1,4,0,4,2
17-Oct-15,2015,10,Fall,2,8,1,9,5
18-Oct-15,2015,10,Fall,1,4,0,4,1
19-Oct-15,2015,10,Fall,1,6,0,6,1
22-Oct-15,2015,10,Fall,1,3,1,4,3
24-Oct-15,2015,10,Fall,1,4,0,4,2
25-Oct-15,2015,10,Fall,3,14,1,15,1
26-Oct-15,2015,10,Fall,1,5,0,5,1
27-Oct-15,2015,10,Fall,1,5,0,5,1
28-Oct-15,2015,10,Fall,1,3,1,4,1
2-Nov-15,2015,11,Fall,1,0,4,4,5
3-Nov-15,2015,11,Fall,1,3,2,5,1
6-Nov-15,2015,11,Fall,1,4,0,4,3
7-Nov-15,2015,11,Fall,1,3,1,4,1
8-Nov-15,2015,11,Fall,2,7,1,8,1
9-Nov-15,2015,11,Fall,1,2,2,4,1
13-Nov-15,2015,11,Fall,1,1,4,5,4
14-Nov-15,2015,11,Fall,1,4,0,4,1
15-Nov-15,2015,11,Fall,2,4,5,9,1
16-Nov-15,2015,11,Fall,1,1,3,4,1
18-Nov-15,2015,11,Fall,1,5,0,5,2
20-Nov-15,2015,11,Fall,1,3,1,4,2
21-Nov-15,2015,11,Fall,1,3,1,4,1
22-Nov-15,2015,11,Fall,6,37,1,38,1
23-Nov-15,2015,11,Fall,2,6,4,10,1
24-Nov-15,2015,11,Fall,1,4,0,4,1
27-Nov-15,2015,11,Fall,2,11,5,16,3
29-Nov-15,2015,11,Fall,1,5,0,5,2
2-Dec-15,2015,12,Winter,2,22,17,39,3
6-Dec-15,2015,12,Winter,2,6,3,9,4
8-Dec-15,2015,12,Winter,1,3,1,4,2
11-Dec-15,2015,12,Winter,2,7,1,8,3
12-Dec-15,2015,12,Winter,2,7,1,8,1
13-Dec-15,2015,12,Winter,2,7,1,8,1
20-Dec-15,2015,12,Winter,3,12,2,14,7
21-Dec-15,2015,12,Winter,1,4,0,4,1
25-Dec-15,2015,12,Winter,2,8,0,8,4
26-Dec-15,2015,12,Winter,1,4,0,4,1
27-Dec-15,2015,12,Winter,1,4,0,4,1
31-Dec-15,2015,12,Winter,1,6,0,6,4
6-Jan-16,2016,1,Winter,1,1,3,4,6
7-Jan-16,2016,1,Winter,1,3,1,4,1
8-Jan-16,2016,1,Winter,2,8,1,9,1
11-Jan-16,2016,1,Winter,1,4,1,5,3
17-Jan-16,2016,1,Winter,1,3,1,4,6
23-Jan-16,2016,1,Winter,1,2,2,4,6
25-Jan-16,2016,1,Winter,1,4,1,5,2
26-Jan-16,2016,1,Winter,1,3,2,5,1
27-Jan-16,2016,1,Winter,1,0,6,6,1
30-Jan-16,2016,1,Winter,1,5,3,8,3
3-Feb-16,2016,2,Winter,1,4,0,4,4
6-Feb-16,2016,2,Winter,3,13,3,16,3
7-Feb-16,2016,2,Winter,4,25,5,30,1
13-Feb-16,2016,2,Winter,1,4,0,4,6
14-Feb-16,2016,2,Winter,2,8,1,9,1
19-Feb-16,2016,2,Winter,2,3,5,8,5
20-Feb-16,2016,2,Winter,5,15,10,25,1
21-Feb-16,2016,2,Winter,2,8,1,9,1
23-Feb-16,2016,2,Winter,2,4,5,9,2
25-Feb-16,2016,2,Winter,1,14,4,18,2
26-Feb-16,2016,2,Winter,1,0,5,5,1
27-Feb-16,2016,2,Winter,1,2,2,4,1
28-Feb-16,2016,2,Winter,2,8,1,9,1
4-Mar-16,2016,3,Spring,1,3,1,4,5
5-Mar-16,2016,3,Spring,1,4,0,4,1
6-Mar-16,2016,3,Spring,3,18,2,20,1
7-Mar-16,2016,3,Spring,2,4,5,9,1
8-Mar-16,2016,3,Spring,1,3,2,5,1
9-Mar-16,2016,3,Spring,1,3,5,8,1
11-Mar-16,2016,3,Spring,2,7,2,9,2
12-Mar-16,2016,3,Spring,2,8,0,8,1
13-Mar-16,2016,3,Spring,1,4,0,4,1
15-Mar-16,2016,3,Spring,1,5,0,5,2
19-Mar-16,2016,3,Spring,2,6,3,9,4
21-Mar-16,2016,3,Spring,1,4,0,4,2
25-Mar-16,2016,3,Spring,2,8,0,8,4
31-Mar-16,2016,3,Spring,1,4,0,4,6
7-Apr-16,2016,4,Spring,1,4,0,4,7
9-Apr-16,2016,4,Spring,3,12,0,12,2
10-Apr-16,2016,4,Spring,2,7,1,8,1
16-Apr-16,2016,4,Spring,3,12,3,15,6
17-Apr-16,2016,4,Spring,3,10,5,15,1
18-Apr-16,2016,4,Spring,1,3,1,4,1
19-Apr-16,2016,4,Spring,3,11,3,14,1
21-Apr-16,2016,4,Spring,1,4,0,4,2
22-Apr-16,2016,4,Spring,2,0,14,14,1
23-Apr-16,2016,4,Spring,4,12,5,17,1
24-Apr-16,2016,4,Spring,3,12,2,14,1
25-Apr-16,2016,4,Spring,2,9,0,9,1
26-Apr-16,2016,4,Spring,1,4,1,5,1
27-Apr-16,2016,4,Spring,2,3,5,8,1
29-Apr-16,2016,4,Spring,2,9,0,9,2
1-May-16,2016,5,Spring,1,5,0,5,2
4-May-16,2016,5,Spring,1,7,1,8,3
5-May-16,2016,5,Spring,2,9,3,12,1
6-May-16,2016,5,Spring,3,10,5,15,1
8-May-16,2016,5,Spring,1,3,1,4,2
11-May-16,2016,5,Spring,2,9,1,10,3
14-May-16,2016,5,Spring,2,8,1,9,3
15-May-16,2016,5,Spring,2,4,5,9,1
17-May-16,2016,5,Spring,1,1,3,4,2
18-May-16,2016,5,Spring,1,4,0,4,1
21-May-16,2016,5,Spring,1,3,1,4,3
22-May-16,2016,5,Spring,3,11,1,12,1
23-May-16,2016,5,Spring,1,5,0,5,1
29-May-16,2016,5,Spring,4,20,2,22,6
30-May-16,2016,5,Spring,2,10,0,10,1
31-May-16,2016,5,Spring,2,8,0,8,1
4-Jun-16,2016,6,Summer,1,1,3,4,4
5-Jun-16,2016,6,Summer,4,15,5,20,1
6-Jun-16,2016,6,Summer,1,4,0,4,1
8-Jun-16,2016,6,Summer,2,7,1,8,2
9-Jun-16,2016,6,Summer,1,4,0,4,1
11-Jun-16,2016,6,Summer,5,12,10,22,2
12-Jun-16,2016,6,Summer,1,53,50,103,1
13-Jun-16,2016,6,Summer,3,14,0,14,1
14-Jun-16,2016,6,Summer,2,7,1,8,1
18-Jun-16,2016,6,Summer,3,9,3,12,4
19-Jun-16,2016,6,Summer,1,4,0,4,1
21-Jun-16,2016,6,Summer,2,6,2,8,2
22-Jun-16,2016,6,Summer,3,9,4,13,1
24-Jun-16,2016,6,Summer,3,11,3,14,2
25-Jun-16,2016,6,Summer,3,13,2,15,1
26-Jun-16,2016,6,Summer,5,20,2,22,1
27-Jun-16,2016,6,Summer,1,1,3,4,1
28-Jun-16,2016,6,Summer,2,7,1,8,1
29-Jun-16,2016,6,Summer,1,0,5,5,1
30-Jun-16,2016,6,Summer,1,4,1,5,1
3-Jul-16,2016,7,Summer,2,7,2,9,3
4-Jul-16,2016,7,Summer,6,27,5,32,1
5-Jul-16,2016,7,Summer,1,4,0,4,1
7-Jul-16,2016,7,Summer,3,17,6,23,2
11-Jul-16,2016,7,Summer,4,15,3,18,4
13-Jul-16,2016,7,Summer,2,7,2,9,2
14-Jul-16,2016,7,Summer,3,8,4,12,1
15-Jul-16,2016,7,Summer,1,1,3,4,1
16-Jul-16,2016,7,Summer,5,34,1,35,1
17-Jul-16,2016,7,Summer,3,10,5,15,1
19-Jul-16,2016,7,Summer,1,4,0,4,2
20-Jul-16,2016,7,Summer,1,4,0,4,1
21-Jul-16,2016,7,Summer,1,5,0,5,1
22-Jul-16,2016,7,Summer,1,5,0,5,1
23-Jul-16,2016,7,Summer,4,11,6,17,1
24-Jul-16,2016,7,Summer,1,7,1,8,1
25-Jul-16,2016,7,Summer,1,19,2,21,1
28-Jul-16,2016,7,Summer,3,11,2,13,3
29-Jul-16,2016,7,Summer,1,7,0,7,1
30-Jul-16,2016,7,Summer,3,11,3,14,1
31-Jul-16,2016,7,Summer,2,5,4,9,1
1-Aug-16,2016,8,Summer,1,4,0,4,1
2-Aug-16,2016,8,Summer,1,4,0,4,1
3-Aug-16,2016,8,Summer,1,3,1,4,1
4-Aug-16,2016,8,Summer,1,4,0,4,1
5-Aug-16,2016,8,Summer,2,5,3,8,1
6-Aug-16,2016,8,Summer,1,0,5,5,1
7-Aug-16,2016,8,Summer,4,12,4,16,1
8-Aug-16,2016,8,Summer,2,9,2,11,1
10-Aug-16,2016,8,Summer,2,7,1,8,2
11-Aug-16,2016,8,Summer,1,4,0,4,1
12-Aug-16,2016,8,Summer,2,6,2,8,1
13-Aug-16,2016,8,Summer,4,14,2,16,1
14-Aug-16,2016,8,Summer,2,9,0,9,1
17-Aug-16,2016,8,Summer,1,4,0,4,3
18-Aug-16,2016,8,Summer,1,4,0,4,1
20-Aug-16,2016,8,Summer,3,9,5,14,2
21-Aug-16,2016,8,Summer,2,17,0,17,1
25-Aug-16,2016,8,Summer,1,5,0,5,4
27-Aug-16,2016,8,Summer,2,10,3,13,2
28-Aug-16,2016,8,Summer,4,17,2,19,1
29-Aug-16,2016,8,Summer,1,5,1,6,1
30-Aug-16,2016,8,Summer,2,8,0,8,1
3-Sep-16,2016,9,Fall,2,7,1,8,4
4-Sep-16,2016,9,Fall,1,10,1,11,1
5-Sep-16,2016,9,Fall,2,7,2,9,1
8-Sep-16,2016,9,Fall,2,4,5,9,3
10-Sep-16,2016,9,Fall,1,3,1,4,2
11-Sep-16,2016,9,Fall,6,25,5,30,1
13-Sep-16,2016,9,Fall,1,2,3,5,2
14-Sep-16,2016,9,Fall,1,3,1,4,1
16-Sep-16,2016,9,Fall,2,7,4,11,2
17-Sep-16,2016,9,Fall,4,21,5,26,1
18-Sep-16,2016,9,Fall,3,11,1,12,1
23-Sep-16,2016,9,Fall,1,0,5,5,5
24-Sep-16,2016,9,Fall,1,8,0,8,1
25-Sep-16,2016,9,Fall,1,3,1,4,1
26-Sep-16,2016,9,Fall,3,14,1,15,1
29-Sep-16,2016,9,Fall,1,3,1,4,3
1-Oct-16,2016,10,Fall,2,4,4,8,2
2-Oct-16,2016,10,Fall,1,4,1,5,1
3-Oct-16,2016,10,Fall,1,4,0,4,1
4-Oct-16,2016,10,Fall,1,2,3,5,1
8-Oct-16,2016,10,Fall,1,4,0,4,4
9-Oct-16,2016,10,Fall,2,11,2,13,1
13-Oct-16,2016,10,Fall,1,4,0,4,4
14-Oct-16,2016,10,Fall,1,6,1,7,1
15-Oct-16,2016,10,Fall,3,21,5,26,1
17-Oct-16,2016,10,Fall,1,4,1,5,2
18-Oct-16,2016,10,Fall,1,4,0,4,1
22-Oct-16,2016,10,Fall,1,7,0,7,4
23-Oct-16,2016,10,Fall,1,5,1,6,1
25-Oct-16,2016,10,Fall,2,6,3,9,2
27-Oct-16,2016,10,Fall,1,0,4,4,2
28-Oct-16,2016,10,Fall,2,10,0,10,1
29-Oct-16,2016,10,Fall,3,12,1,13,1
30-Oct-16,2016,10,Fall,5,21,5,26,1
31-Oct-16,2016,10,Fall,1,4,0,4,1
1-Nov-16,2016,11,Fall,1,5,1,6,1
2-Nov-16,2016,11,Fall,1,4,1,5,1
3-Nov-16,2016,11,Fall,2,4,4,8,1
4-Nov-16,2016,11,Fall,1,4,0,4,1
5-Nov-16,2016,11,Fall,5,25,1,26,1
9-Nov-16,2016,11,Fall,3,12,1,13,4
10-Nov-16,2016,11,Fall,1,3,1,4,1
11-Nov-16,2016,11,Fall,1,4,0,4,1
12-Nov-16,2016,11,Fall,3,13,2,15,1
13-Nov-16,2016,11,Fall,4,12,6,18,1
17-Nov-16,2016,11,Fall,1,7,1,8,4
18-Nov-16,2016,11,Fall,1,4,0,4,1
22-Nov-16,2016,11,Fall,1,4,1,5,4
23-Nov-16,2016,11,Fall,1,4,0,4,1
24-Nov-16,2016,11,Fall,2,7,3,10,1
25-Nov-16,2016,11,Fall,1,4,0,4,1
26-Nov-16,2016,11,Fall,1,5,1,6,1
27-Nov-16,2016,11,Fall,2,16,1,17,1
28-Nov-16,2016,11,Fall,3,11,1,12,1
30-Nov-16,2016,11,Fall,1,4,2,6,2
1-Dec-16,2016,12,Winter,1,3,1,4,1
2-Dec-16,2016,12,Winter,1,6,0,6,1
3-Dec-16,2016,12,Winter,1,6,0,6,1
5-Dec-16,2016,12,Winter,1,1,4,5,2
9-Dec-16,2016,12,Winter,2,4,4,8,4
11-Dec-16,2016,12,Winter,4,17,1,18,2
12-Dec-16,2016,12,Winter,1,3,1,4,1
16-Dec-16,2016,12,Winter,2,6,2,8,4
17-Dec-16,2016,12,Winter,2,4,5,9,1
23-Dec-16,2016,12,Winter,2,7,1,8,6
24-Dec-16,2016,12,Winter,2,7,4,11,1
25-Dec-16,2016,12,Winter,3,13,4,17,1
28-Dec-16,2016,12,Winter,1,4,1,5,3
30-Dec-16,2016,12,Winter,2,8,2,10,2
31-Dec-16,2016,12,Winter,2,5,3,8,1
1-Jan-17,2017,1,Winter,3,15,1,16,1
3-Jan-17,2017,1,Winter,1,4,0,4,2
4-Jan-17,2017,1,Winter,1,1,3,4,1
6-Jan-17,2017,1,Winter,2,8,7,15,2
7-Jan-17,2017,1,Winter,1,3,1,4,1
11-Jan-17,2017,1,Winter,2,6,2,8,4
12-Jan-17,2017,1,Winter,2,4,5,9,1
15-Jan-17,2017,1,Winter,2,5,4,9,3
16-Jan-17,2017,1,Winter,2,12,0,12,1
20-Jan-17,2017,1,Winter,2,8,1,9,4
21-Jan-17,2017,1,Winter,3,13,2,15,1
22-Jan-17,2017,1,Winter,3,7,6,13,1
25-Jan-17,2017,1,Winter,1,6,0,6,3
26-Jan-17,2017,1,Winter,1,3,2,5,1
27-Jan-17,2017,1,Winter,2,10,4,14,1
29-Jan-17,2017,1,Winter,1,4,1,5,2
30-Jan-17,2017,1,Winter,1,4,0,4,1
31-Jan-17,2017,1,Winter,2,8,0,8,1
6-Feb-17,2017,2,Winter,1,0,4,4,6
7-Feb-17,2017,2,Winter,2,8,1,9,1
8-Feb-17,2017,2,Winter,1,4,1,5,1
9-Feb-17,2017,2,Winter,1,0,4,4,1
10-Feb-17,2017,2,Winter,1,5,1,6,1
11-Feb-17,2017,2,Winter,2,7,1,8,1
12-Feb-17,2017,2,Winter,3,14,2,16,1
15-Feb-17,2017,2,Winter,2,6,3,9,3
18-Feb-17,2017,2,Winter,2,7,1,8,3
19-Feb-17,2017,2,Winter,1,3,1,4,1
20-Feb-17,2017,2,Winter,1,5,0,5,1
21-Feb-17,2017,2,Winter,2,4,4,8,1
22-Feb-17,2017,2,Winter,1,4,0,4,1
25-Feb-17,2017,2,Winter,2,7,3,10,3
26-Feb-17,2017,2,Winter,1,4,1,5,1
27-Feb-17,2017,2,Winter,1,4,0,4,1
28-Feb-17,2017,2,Winter,1,6,0,6,1
3-Mar-17,2017,3,Spring,2,9,0,9,3
4-Mar-17,2017,3,Spring,2,8,1,9,1
5-Mar-17,2017,3,Spring,1,4,0,4,1
7-Mar-17,2017,3,Spring,1,4,0,4,2
10-Mar-17,2017,3,Spring,2,3,5,8,3
15-Mar-17,2017,3,Spring,1,1,3,4,5
18-Mar-17,2017,3,Spring,1,2,3,5,3
19-Mar-17,2017,3,Spring,1,5,1,6,1
22-Mar-17,2017,3,Spring,1,0,5,5,3
24-Mar-17,2017,3,Spring,2,10,2,12,2
25-Mar-17,2017,3,Spring,3,9,4,13,1
26-Mar-17,2017,3,Spring,3,21,6,27,1
27-Mar-17,2017,3,Spring,1,4,2,6,1
30-Mar-17,2017,3,Spring,1,0,4,4,3
1-Apr-17,2017,4,Spring,3,12,3,15,2
2-Apr-17,2017,4,Spring,2,9,2,11,1
3-Apr-17,2017,4,Spring,2,8,3,11,1
6-Apr-17,2017,4,Spring,1,3,1,4,3
7-Apr-17,2017,4,Spring,4,7,13,20,1
9-Apr-17,2017,4,Spring,2,6,2,8,2
13-Apr-17,2017,4,Spring,1,3,1,4,4
15-Apr-17,2017,4,Spring,6,26,0,26,2
16-Apr-17,2017,4,Spring,3,17,0,17,1
20-Apr-17,2017,4,Spring,1,4,0,4,4
21-Apr-17,2017,4,Spring,1,2,2,4,1
26-Apr-17,2017,4,Spring,1,4,0,4,5
27-Apr-17,2017,4,Spring,1,3,1,4,1
28-Apr-17,2017,4,Spring,1,4,0,4,1
29-Apr-17,2017,4,Spring,6,24,3,27,1
30-Apr-17,2017,4,Spring,4,17,7,24,1
1-May-17,2017,5,Spring,1,3,2,5,1
2-May-17,2017,5,Spring,1,3,1,4,1
4-May-17,2017,5,Spring,1,3,1,4,2
7-May-17,2017,5,Spring,1,8,2,10,3
9-May-17,2017,5,Spring,1,1,3,4,2
10-May-17,2017,5,Spring,1,3,1,4,1
14-May-17,2017,5,Spring,4,20,1,21,4
16-May-17,2017,5,Spring,1,1,3,4,2
20-May-17,2017,5,Spring,1,10,0,10,4
21-May-17,2017,5,Spring,2,7,1,8,1
26-May-17,2017,5,Spring,1,4,0,4,5
27-May-17,2017,5,Spring,3,12,9,21,1
28-May-17,2017,5,Spring,3,22,1,23,1
29-May-17,2017,5,Spring,1,3,1,4,1
30-May-17,2017,5,Spring,1,3,1,4,1
1-Jun-17,2017,6,Summer,1,1,3,4,2
2-Jun-17,2017,6,Summer,2,6,3,9,1
3-Jun-17,2017,6,Summer,2,4,5,9,1
5-Jun-17,2017,6,Summer,1,0,6,6,2
6-Jun-17,2017,6,Summer,1,2,3,5,1
8-Jun-17,2017,6,Summer,1,6,0,6,2
9-Jun-17,2017,6,Summer,1,5,2,7,1
10-Jun-17,2017,6,Summer,1,4,0,4,1
11-Jun-17,2017,6,Summer,3,17,0,17,1
13-Jun-17,2017,6,Summer,3,10,2,12,2
14-Jun-17,2017,6,Summer,3,11,5,16,1
15-Jun-17,2017,6,Summer,2,3,6,9,1
17-Jun-17,2017,6,Summer,2,8,1,9,2
18-Jun-17,2017,6,Summer,4,17,3,20,1
22-Jun-17,2017,6,Summer,1,6,1,7,4
24-Jun-17,2017,6,Summer,3,13,1,14,2
25-Jun-17,2017,6,Summer,2,7,1,8,1
27-Jun-17,2017,6,Summer,1,5,0,5,2
30-Jun-17,2017,6,Summer,1,6,2,8,3
1-Jul-17,2017,7,Summer,4,35,2,37,1
2-Jul-17,2017,7,Summer,2,8,0,8,1
3-Jul-17,2017,7,Summer,2,4,4,8,1
4-Jul-17,2017,7,Summer,3,11,2,13,1
5-Jul-17,2017,7,Summer,3,7,6,13,1
6-Jul-17,2017,7,Summer,1,4,0,4,1
8-Jul-17,2017,7,Summer,2,12,1,13,2
9-Jul-17,2017,7,Summer,1,7,0,7,1
15-Jul-17,2017,7,Summer,2,7,1,8,6
18-Jul-17,2017,7,Summer,3,11,1,12,3
19-Jul-17,2017,7,Summer,2,8,1,9,1
22-Jul-17,2017,7,Summer,1,5,0,5,3
23-Jul-17,2017,7,Summer,2,7,1,8,1
25-Jul-17,2017,7,Summer,1,3,1,4,2
26-Jul-17,2017,7,Summer,1,6,1,7,1
27-Jul-17,2017,7,Summer,1,4,1,5,1
28-Jul-17,2017,7,Summer,1,4,0,4,1
29-Jul-17,2017,7,Summer,2,7,3,10,1
30-Jul-17,2017,7,Summer,2,8,2,10,1
31-Jul-17,2017,7,Summer,1,4,0,4,1
1-Aug-17,2017,8,Summer,3,17,0,17,1
2-Aug-17,2017,8,Summer,1,4,0,4,1
3-Aug-17,2017,8,Summer,1,3,1,4,1
4-Aug-17,2017,8,Summer,1,2,3,5,1
5-Aug-17,2017,8,Summer,3,10,2,12,1
6-Aug-17,2017,8,Summer,3,17,0,17,1
8-Aug-17,2017,8,Summer,1,6,1,7,2
12-Aug-17,2017,8,Summer,1,3,1,4,4
13-Aug-17,2017,8,Summer,3,13,0,13,1
14-Aug-17,2017,8,Summer,1,2,2,4,1
16-Aug-17,2017,8,Summer,1,4,0,4,2
19-Aug-17,2017,8,Summer,1,4,1,5,3
20-Aug-17,2017,8,Summer,2,9,2,11,1
21-Aug-17,2017,8,Summer,5,14,6,20,1
22-Aug-17,2017,8,Summer,1,4,0,4,1
24-Aug-17,2017,8,Summer,1,0,4,4,2
25-Aug-17,2017,8,Summer,1,4,0,4,1
27-Aug-17,2017,8,Summer,2,7,2,9,2
28-Aug-17,2017,8,Summer,1,4,2,6,1
2-Sep-17,2017,9,Fall,2,7,1,8,5
3-Sep-17,2017,9,Fall,1,3,2,5,1
4-Sep-17,2017,9,Fall,1,4,0,4,1
6-Sep-17,2017,9,Fall,1,4,0,4,2
9-Sep-17,2017,9,Fall,1,4,0,4,3
10-Sep-17,2017,9,Fall,2,4,10,14,1
13-Sep-17,2017,9,Fall,4,16,2,18,3
16-Sep-17,2017,9,Fall,1,8,0,8,3
17-Sep-17,2017,9,Fall,2,7,2,9,1
20-Sep-17,2017,9,Fall,1,5,0,5,3
23-Sep-17,2017,9,Fall,3,11,3,14,3
24-Sep-17,2017,9,Fall,4,19,2,21,1
26-Sep-17,2017,9,Fall,3,9,3,12,2
28-Sep-17,2017,9,Fall,1,3,1,4,2
30-Sep-17,2017,9,Fall,1,3,1,4,2
1-Oct-17,2017,10,Fall,2,443,62,505,1
3-Oct-17,2017,10,Fall,1,4,0,4,2
5-Oct-17,2017,10,Fall,1,0,4,4,2
6-Oct-17,2017,10,Fall,1,5,0,5,1
7-Oct-17,2017,10,Fall,1,4,0,4,1
9-Oct-17,2017,10,Fall,1,5,0,5,2
10-Oct-17,2017,10,Fall,1,4,0,4,1
11-Oct-17,2017,10,Fall,1,0,4,4,1
12-Oct-17,2017,10,Fall,1,2,2,4,1
15-Oct-17,2017,10,Fall,2,5,3,8,3
16-Oct-17,2017,10,Fall,1,3,1,4,1
17-Oct-17,2017,10,Fall,1,4,0,4,1
18-Oct-17,2017,10,Fall,1,3,3,6,1
21-Oct-17,2017,10,Fall,4,16,0,16,3
22-Oct-17,2017,10,Fall,2,11,2,13,1
23-Oct-17,2017,10,Fall,1,3,2,5,1
27-Oct-17,2017,10,Fall,2,10,0,10,4
28-Oct-17,2017,10,Fall,2,7,1,8,1
29-Oct-17,2017,10,Fall,1,3,1,4,1
3-Nov-17,2017,11,Fall,4,16,1,17,5
4-Nov-17,2017,11,Fall,3,11,1,12,1
5-Nov-17,2017,11,Fall,1,20,27,47,1
9-Nov-17,2017,11,Fall,1,4,0,4,4
10-Nov-17,2017,11,Fall,1,4,0,4,1
11-Nov-17,2017,11,Fall,3,13,3,16,1
12-Nov-17,2017,11,Fall,3,14,2,16,1
14-Nov-17,2017,11,Fall,2,14,8,22,2
16-Nov-17,2017,11,Fall,1,7,0,7,2
17-Nov-17,2017,11,Fall,1,4,0,4,1
18-Nov-17,2017,11,Fall,1,4,0,4,1
24-Nov-17,2017,11,Fall,2,11,2,13,6
30-Nov-17,2017,11,Fall,1,4,1,5,6
2-Dec-17,2017,12,Winter,1,4,0,4,2
3-Dec-17,2017,12,Winter,1,3,1,4,1
4-Dec-17,2017,12,Winter,1,2,2,4,1
6-Dec-17,2017,12,Winter,1,4,0,4,2
9-Dec-17,2017,12,Winter,1,4,0,4,3
12-Dec-17,2017,12,Winter,2,8,0,8,3
13-Dec-17,2017,12,Winter,1,3,1,4,1
15-Dec-17,2017,12,Winter,1,5,0,5,2
16-Dec-17,2017,12,Winter,1,4,0,4,1
21-Dec-17,2017,12,Winter,2,7,1,8,5
23-Dec-17,2017,12,Winter,2,7,1,8,2
24-Dec-17,2017,12,Winter,2,9,1,10,1
26-Dec-17,2017,12,Winter,1,5,0,5,2
27-Dec-17,2017,12,Winter,1,2,2,4,1
31-Dec-17,2017,12,Winter,3,10,6,16,4
1-Jan-18,2018,1,Winter,1,3,1,4,1
4-Jan-18,2018,1,Winter,1,3,1,4,3
5-Jan-18,2018,1,Winter,1,6,0,6,1
7-Jan-18,2018,1,Winter,2,9,1,10,2
11-Jan-18,2018,1,Winter,1,2,2,4,4
12-Jan-18,2018,1,Winter,1,2,3,5,1
14-Jan-18,2018,1,Winter,2,8,1,9,2
15-Jan-18,2018,1,Winter,1,5,0,5,1
17-Jan-18,2018,1,Winter,1,3,1,4,2
21-Jan-18,2018,1,Winter,2,8,0,8,4
23-Jan-18,2018,1,Winter,2,18,2,20,2
25-Jan-18,2018,1,Winter,1,4,0,4,2
27-Jan-18,2018,1,Winter,2,9,0,9,2
28-Jan-18,2018,1,Winter,3,3,11,14,1
31-Jan-18,2018,1,Winter,1,4,0,4,3
3-Feb-18,2018,2,Winter,1,5,1,6,3
5-Feb-18,2018,2,Winter,1,4,2,6,2
7-Feb-18,2018,2,Winter,1,3,3,6,2
10-Feb-18,2018,2,Winter,1,0,5,5,3
11-Feb-18,2018,2,Winter,1,3,4,7,1
13-Feb-18,2018,2,Winter,1,3,2,5,2
14-Feb-18,2018,2,Winter,1,17,17,34,1
16-Feb-18,2018,2,Winter,1,3,1,4,2
17-Feb-18,2018,2,Winter,2,12,1,13,1
18-Feb-18,2018,2,Winter,1,5,0,5,1
23-Feb-18,2018,2,Winter,1,3,1,4,5
26-Feb-18,2018,2,Winter,1,0,5,5,3
27-Feb-18,2018,2,Winter,1,4,0,4,1
3-Mar-18,2018,3,Spring,2,7,1,8,4
4-Mar-18,2018,3,Spring,1,4,1,5,1
7-Mar-18,2018,3,Spring,1,2,2,4,3
9-Mar-18,2018,3,Spring,1,1,3,4,2
11-Mar-18,2018,3,Spring,3,13,2,15,2
12-Mar-18,2018,3,Spring,1,4,0,4,1
13-Mar-18,2018,3,Spring,1,4,0,4,1
17-Mar-18,2018,3,Spring,2,11,0,11,4
21-Mar-18,2018,3,Spring,1,5,1,6,4
24-Mar-18,2018,3,Spring,1,4,0,4,3
29-Mar-18,2018,3,Spring,2,7,1,8,5
31-Mar-18,2018,3,Spring,1,5,0,5,2
1-Apr-18,2018,4,Spring,2,9,1,10,1
2-Apr-18,2018,4,Spring,1,3,1,4,1
4-Apr-18,2018,4,Spring,1,2,2,4,2
6-Apr-18,2018,4,Spring,2,7,1,8,2
8-Apr-18,2018,4,Spring,2,5,3,8,2
9-Apr-18,2018,4,Spring,1,4,0,4,1
15-Apr-18,2018,4,Spring,1,6,0,6,6
18-Apr-18,2018,4,Spring,1,3,4,7,3
20-Apr-18,2018,4,Spring,1,5,1,6,2
21-Apr-18,2018,4,Spring,1,2,2,4,1
22-Apr-18,2018,4,Spring,2,8,5,13,1
24-Apr-18,2018,4,Spring,1,4,0,4,2
25-Apr-18,2018,4,Spring,2,5,3,8,1
28-Apr-18,2018,4,Spring,1,5,0,5,3
29-Apr-18,2018,4,Spring,4,12,4,16,1
30-Apr-18,2018,4,Spring,2,8,0,8,1
1-May-18,2018,5,Spring,1,5,0,5,1
2-May-18,2018,5,Spring,3,14,2,16,1
4-May-18,2018,5,Spring,2,8,0,8,2
5-May-18,2018,5,Spring,1,5,0,5,1
6-May-18,2018,5,Spring,2,8,2,10,1
7-May-18,2018,5,Spring,1,5,0,5,1
9-May-18,2018,5,Spring,2,8,0,8,2
11-May-18,2018,5,Spring,2,8,1,9,2
12-May-18,2018,5,Spring,2,10,0,10,1
13-May-18,2018,5,Spring,3,8,5,13,1
14-May-18,2018,5,Spring,1,4,0,4,1
16-May-18,2018,5,Spring,1,1,5,6,2
18-May-18,2018,5,Spring,1,13,10,23,2
20-May-18,2018,5,Spring,2,11,1,12,2
25-May-18,2018,5,Spring,1,4,0,4,5
27-May-18,2018,5,Spring,2,7,1,8,2
31-May-18,2018,5,Spring,1,2,3,5,4
2-Jun-18,2018,6,Summer,2,11,1,12,2
3-Jun-18,2018,6,Summer,2,8,1,9,1
5-Jun-18,2018,6,Summer,1,1,3,4,2
9-Jun-18,2018,6,Summer,3,12,1,13,4
10-Jun-18,2018,6,Summer,6,29,5,34,1
11-Jun-18,2018,6,Summer,2,5,5,10,1
12-Jun-18,2018,6,Summer,1,4,0,4,1
14-Jun-18,2018,6,Summer,5,20,3,23,2
17-Jun-18,2018,6,Summer,4,30,2,32,3
18-Jun-18,2018,6,Summer,2,4,5,9,1
19-Jun-18,2018,6,Summer,1,4,0,4,1
20-Jun-18,2018,6,Summer,1,5,0,5,1
21-Jun-18,2018,6,Summer,3,11,1,12,1
22-Jun-18,2018,6,Summer,1,3,1,4,1
23-Jun-18,2018,6,Summer,3,12,1,13,1
24-Jun-18,2018,6,Summer,6,25,3,28,1
25-Jun-18,2018,6,Summer,1,6,0,6,1
27-Jun-18,2018,6,Summer,3,11,1,12,2
28-Jun-18,2018,6,Summer,1,0,5,5,1
30-Jun-18,2018,6,Summer,3,17,1,18,2
1-Jul-18,2018,7,Summer,1,6,0,6,1
2-Jul-18,2018,7,Summer,1,2,2,4,1
3-Jul-18,2018,7,Summer,2,9,1,10,1
4-Jul-18,2018,7,Summer,2,6,2,8,1
5-Jul-18,2018,7,Summer,5,22,4,26,1
7-Jul-18,2018,7,Summer,1,2,3,5,2
8-Jul-18,2018,7,Summer,2,10,0,10,1
9-Jul-18,2018,7,Summer,2,4,6,10,1
11-Jul-18,2018,7,Summer,2,8,0,8,2
12-Jul-18,2018,7,Summer,1,5,0,5,1
13-Jul-18,2018,7,Summer,1,3,1,4,1
14-Jul-18,2018,7,Summer,1,4,0,4,1
15-Jul-18,2018,7,Summer,2,9,0,9,1
16-Jul-18,2018,7,Summer,3,12,4,16,1
18-Jul-18,2018,7,Summer,1,4,0,4,2
20-Jul-18,2018,7,Summer,2,8,1,9,2
21-Jul-18,2018,7,Summer,2,9,2,11,1
23-Jul-18,2018,7,Summer,1,5,0,5,2
25-Jul-18,2018,7,Summer,1,4,0,4,2
26-Jul-18,2018,7,Summer,3,14,3,17,1
27-Jul-18,2018,7,Summer,2,4,5,9,1
28-Jul-18,2018,7,Summer,2,11,5,16,1
29-Jul-18,2018,7,Summer,3,12,1,13,1
30-Jul-18,2018,7,Summer,2,8,0,8,1
31-Jul-18,2018,7,Summer,1,3,2,5,1
4-Aug-18,2018,8,Summer,4,19,1,20,4
5-Aug-18,2018,8,Summer,5,25,2,27,1
8-Aug-18,2018,8,Summer,2,8,2,10,3
10-Aug-18,2018,8,Summer,2,8,0,8,2
11-Aug-18,2018,8,Summer,3,11,2,13,1
12-Aug-18,2018,8,Summer,2,5,4,9,1
14-Aug-18,2018,8,Summer,1,5,0,5,2
15-Aug-18,2018,8,Summer,1,5,0,5,1
17-Aug-18,2018,8,Summer,1,7,0,7,2
18-Aug-18,2018,8,Summer,1,4,0,4,1
19-Aug-18,2018,8,Summer,1,5,0,5,1
20-Aug-18,2018,8,Summer,2,7,2,9,1
21-Aug-18,2018,8,Summer,1,4,0,4,1
22-Aug-18,2018,8,Summer,1,4,0,4,1
23-Aug-18,2018,8,Summer,2,8,0,8,1
25-Aug-18,2018,8,Summer,2,9,1,10,2
26-Aug-18,2018,8,Summer,2,12,4,16,1
27-Aug-18,2018,8,Summer,1,3,1,4,1
31-Aug-18,2018,8,Summer,1,3,2,5,4
1-Sep-18,2018,9,Fall,2,10,2,12,1
2-Sep-18,2018,9,Fall,6,29,2,31,1
4-Sep-18,2018,9,Fall,1,4,0,4,2
6-Sep-18,2018,9,Fall,1,2,4,6,2
7-Sep-18,2018,9,Fall,1,3,1,4,1
9-Sep-18,2018,9,Fall,3,11,2,13,2
10-Sep-18,2018,9,Fall,1,5,0,5,1
11-Sep-18,2018,9,Fall,1,4,0,4,1
12-Sep-18,2018,9,Fall,1,0,6,6,1
15-Sep-18,2018,9,Fall,1,4,0,4,3
17-Sep-18,2018,9,Fall,1,1,4,5,2
18-Sep-18,2018,9,Fall,2,8,0,8,1
19-Sep-18,2018,9,Fall,3,12,2,14,1
20-Sep-18,2018,9,Fall,2,8,4,12,1
22-Sep-18,2018,9,Fall,2,8,0,8,2
23-Sep-18,2018,9,Fall,2,8,1,9,1
24-Sep-18,2018,9,Fall,1,2,3,5,1
28-Sep-18,2018,9,Fall,1,2,2,4,4
29-Sep-18,2018,9,Fall,1,4,1,5,1
30-Sep-18,2018,9,Fall,1,3,1,4,1
1-Oct-18,2018,10,Fall,1,2,2,4,1
3-Oct-18,2018,10,Fall,2,10,3,13,2
4-Oct-18,2018,10,Fall,2,7,1,8,1
6-Oct-18,2018,10,Fall,3,13,1,14,2
8-Oct-18,2018,10,Fall,1,4,0,4,2
12-Oct-18,2018,10,Fall,2,10,0,10,4
13-Oct-18,2018,10,Fall,2,5,4,9,1
14-Oct-18,2018,10,Fall,3,7,5,12,1
15-Oct-18,2018,10,Fall,1,0,5,5,1
16-Oct-18,2018,10,Fall,1,4,0,4,1
21-Oct-18,2018,10,Fall,2,8,2,10,5
22-Oct-18,2018,10,Fall,1,6,0,6,1
24-Oct-18,2018,10,Fall,1,5,0,5,2
26-Oct-18,2018,10,Fall,1,3,1,4,2
27-Oct-18,2018,10,Fall,2,12,11,23,1
28-Oct-18,2018,10,Fall,1,2,2,4,1
29-Oct-18,2018,10,Fall,1,7,0,7,1
30-Oct-18,2018,10,Fall,2,8,2,10,1
31-Oct-18,2018,10,Fall,1,3,1,4,1
1-Nov-18,2018,11,Fall,2,7,2,9,1
2-Nov-18,2018,11,Fall,2,9,3,12,1
3-Nov-18,2018,11,Fall,1,5,0,5,1
7-Nov-18,2018,11,Fall,1,2,13,15,4
11-Nov-18,2018,11,Fall,1,1,3,4,4
12-Nov-18,2018,11,Fall,1,1,3,4,1
13-Nov-18,2018,11,Fall,2,3,6,9,1
14-Nov-18,2018,11,Fall,1,1,3,4,1
16-Nov-18,2018,11,Fall,1,1,3,4,2
18-Nov-18,2018,11,Fall,1,4,1,5,2
19-Nov-18,2018,11,Fall,2,4,5,9,1
21-Nov-18,2018,11,Fall,1,4,0,4,2
22-Nov-18,2018,11,Fall,1,2,3,5,1
23-Nov-18,2018,11,Fall,1,5,2,7,1
25-Nov-18,2018,11,Fall,3,9,3,12,2
26-Nov-18,2018,11,Fall,1,4,0,4,1
1-Dec-18,2018,12,Winter,1,5,0,5,5
8-Dec-18,2018,12,Winter,2,10,0,10,7
9-Dec-18,2018,12,Winter,2,7,1,8,1
11-Dec-18,2018,12,Winter,1,3,1,4,2
13-Dec-18,2018,12,Winter,1,4,0,4,2
14-Dec-18,2018,12,Winter,1,3,1,4,1
15-Dec-18,2018,12,Winter,1,5,0,5,1
18-Dec-18,2018,12,Winter,1,5,0,5,3
22-Dec-18,2018,12,Winter,1,4,0,4,4
23-Dec-18,2018,12,Winter,1,7,0,7,1
24-Dec-18,2018,12,Winter,1,2,2,4,1
28-Dec-18,2018,12,Winter,1,1,4,5,4
29-Dec-18,2018,12,Winter,1,3,1,4,1
31-Dec-18,2018,12,Winter,1,2,3,5,2
1-Jan-19,2019,1,Winter,2,10,0,10,1
2-Jan-19,2019,1,Winter,1,3,1,4,1
3-Jan-19,2019,1,Winter,1,3,1,4,1
4-Jan-19,2019,1,Winter,2,6,6,12,1
6-Jan-19,2019,1,Winter,1,4,0,4,2
13-Jan-19,2019,1,Winter,1,5,1,6,7
15-Jan-19,2019,1,Winter,1,4,1,5,2
16-Jan-19,2019,1,Winter,2,6,4,10,1
17-Jan-19,2019,1,Winter,1,1,3,4,1
19-Jan-19,2019,1,Winter,5,16,7,23,2
20-Jan-19,2019,1,Winter,1,4,0,4,1
23-Jan-19,2019,1,Winter,1,0,5,5,3
24-Jan-19,2019,1,Winter,2,2,8,10,1
26-Jan-19,2019,1,Winter,4,12,6,18,2
27-Jan-19,2019,1,Winter,1,5,0,5,1
28-Jan-19,2019,1,Winter,1,4,2,6,1
1-Feb-19,2019,2,Winter,1,4,0,4,4
3-Feb-19,2019,2,Winter,2,5,6,11,2
4-Feb-19,2019,2,Winter,2,9,0,9,1
5-Feb-19,2019,2,Winter,1,2,2,4,1
6-Feb-19,2019,2,Winter,1,3,1,4,1
9-Feb-19,2019,2,Winter,1,4,0,4,3
11-Feb-19,2019,2,Winter,1,0,5,5,2
15-Feb-19,2019,2,Winter,1,6,6,12,4
16-Feb-19,2019,2,Winter,1,0,5,5,1
17-Feb-19,2019,2,Winter,3,12,3,15,1
20-Feb-19,2019,2,Winter,1,4,0,4,3
21-Feb-19,2019,2,Winter,3,8,5,13,1
22-Feb-19,2019,2,Winter,1,2,2,4,1
28-Feb-19,2019,2,Winter,1,3,1,4,6
2-Mar-19,2019,3,Spring,1,4,1,5,2
3-Mar-19,2019,3,Spring,2,10,0,10,1
10-Mar-19,2019,3,Spring,2,8,1,9,7
11-Mar-19,2019,3,Spring,1,4,0,4,1
14-Mar-19,2019,3,Spring,1,3,1,4,3
15-Mar-19,2019,3,Spring,1,4,2,6,1
16-Mar-19,2019,3,Spring,1,3,1,4,1
17-Mar-19,2019,3,Spring,3,11,1,12,1
19-Mar-19,2019,3,Spring,1,4,2,6,2
24-Mar-19,2019,3,Spring,2,12,1,13,5
25-Mar-19,2019,3,Spring,1,5,0,5,1
28-Mar-19,2019,3,Spring,1,4,0,4,3
31-Mar-19,2019,3,Spring,3,15,2,17,3
2-Apr-19,2019,4,Spring,2,9,0,9,2
4-Apr-19,2019,4,Spring,2,5,4,9,2
6-Apr-19,2019,4,Spring,2,10,0,10,2
7-Apr-19,2019,4,Spring,4,19,2,21,1
9-Apr-19,2019,4,Spring,1,3,1,4,2
11-Apr-19,2019,4,Spring,3,9,5,14,2
12-Apr-19,2019,4,Spring,1,4,0,4,1
13-Apr-19,2019,4,Spring,1,4,0,4,1
14-Apr-19,2019,4,Spring,3,9,3,12,1
16-Apr-19,2019,4,Spring,1,3,1,4,2
18-Apr-19,2019,4,Spring,1,4,0,4,2
19-Apr-19,2019,4,Spring,1,4,0,4,1
20-Apr-19,2019,4,Spring,2,9,0,9,1
21-Apr-19,2019,4,Spring,1,4,0,4,1
27-Apr-19,2019,4,Spring,3,12,2,14,6
28-Apr-19,2019,4,Spring,4,18,5,23,1
30-Apr-19,2019,4,Spring,1,4,2,6,2
1-May-19,2019,5,Spring,1,3,1,4,1
3-May-19,2019,5,Spring,3,12,1,13,2
4-May-19,2019,5,Spring,4,16,2,18,1
5-May-19,2019,5,Spring,2,10,1,11,1
7-May-19,2019,5,Spring,1,8,1,9,2
8-May-19,2019,5,Spring,1,4,0,4,1
10-May-19,2019,5,Spring,2,11,0,11,2
11-May-19,2019,5,Spring,2,8,0,8,1
13-May-19,2019,5,Spring,2,5,4,9,2
14-May-19,2019,5,Spring,1,4,0,4,1
15-May-19,2019,5,Spring,1,4,0,4,1
16-May-19,2019,5,Spring,1,4,0,4,1
17-May-19,2019,5,Spring,1,3,1,4,1
18-May-19,2019,5,Spring,7,32,8,40,1
19-May-19,2019,5,Spring,1,5,0,5,1
20-May-19,2019,5,Spring,3,10,3,13,1
25-May-19,2019,5,Spring,5,29,4,33,5
26-May-19,2019,5,Spring,3,11,2,13,1
27-May-19,2019,5,Spring,3,12,3,15,1
29-May-19,2019,5,Spring,2,5,4,9,2
30-May-19,2019,5,Spring,1,5,0,5,1
31-May-19,2019,5,Spring,2,7,14,21,1
1-Jun-19,2019,6,Summer,6,24,2,26,1
5-Jun-19,2019,6,Summer,1,4,0,4,4
6-Jun-19,2019,6,Summer,1,3,1,4,1
7-Jun-19,2019,6,Summer,1,5,0,5,1
8-Jun-19,2019,6,Summer,2,6,5,11,1
9-Jun-19,2019,6,Summer,3,10,2,12,1
11-Jun-19,2019,6,Summer,2,6,2,8,2
12-Jun-19,2019,6,Summer,1,3,1,4,1
15-Jun-19,2019,6,Summer,1,4,0,4,3
16-Jun-19,2019,6,Summer,3,17,2,19,1
17-Jun-19,2019,6,Summer,2,9,0,9,1
18-Jun-19,2019,6,Summer,1,4,1,5,1
20-Jun-19,2019,6,Summer,1,10,0,10,2
21-Jun-19,2019,6,Summer,4,12,6,18,1
22-Jun-19,2019,6,Summer,3,12,1,13,1
23-Jun-19,2019,6,Summer,5,19,10,29,1
26-Jun-19,2019,6,Summer,2,7,1,8,3
27-Jun-19,2019,6,Summer,1,7,0,7,1
28-Jun-19,2019,6,Summer,5,25,0,25,1
29-Jun-19,2019,6,Summer,4,20,0,20,1
30-Jun-19,2019,6,Summer,4,17,2,19,1
1-Jul-19,2019,7,Summer,1,4,0,4,1
2-Jul-19,2019,7,Summer,1,4,0,4,1
3-Jul-19,2019,7,Summer,1,3,2,5,1
4-Jul-19,2019,7,Summer,4,14,2,16,1
5-Jul-19,2019,7,Summer,4,18,1,19,1
6-Jul-19,2019,7,Summer,2,4,5,9,1
7-Jul-19,2019,7,Summer,5,23,0,23,1
8-Jul-19,2019,7,Summer,1,2,2,4,1
11-Jul-19,2019,7,Summer,1,4,0,4,3
13-Jul-19,2019,7,Summer,2,11,1,12,2
14-Jul-19,2019,7,Summer,1,4,0,4,1
15-Jul-19,2019,7,Summer,1,4,0,4,1
16-Jul-19,2019,7,Summer,1,4,0,4,1
17-Jul-19,2019,7,Summer,1,3,1,4,1
18-Jul-19,2019,7,Summer,1,3,1,4,1
20-Jul-19,2019,7,Summer,3,14,1,15,2
21-Jul-19,2019,7,Summer,2,8,0,8,1
25-Jul-19,2019,7,Summer,1,2,4,6,4
26-Jul-19,2019,7,Summer,1,3,1,4,1
27-Jul-19,2019,7,Summer,2,14,2,16,1
28-Jul-19,2019,7,Summer,5,28,11,39,1
30-Jul-19,2019,7,Summer,1,5,0,5,2
2-Aug-19,2019,8,Summer,1,3,2,5,3
3-Aug-19,2019,8,Summer,1,24,22,46,1
4-Aug-19,2019,8,Summer,4,43,12,55,1
5-Aug-19,2019,8,Summer,2,7,1,8,1
7-Aug-19,2019,8,Summer,1,2,2,4,2
9-Aug-19,2019,8,Summer,1,4,0,4,2
10-Aug-19,2019,8,Summer,2,8,0,8,1
11-Aug-19,2019,8,Summer,1,6,0,6,1
